a	अ
aa	आ
i	इ
ii	ई
u	उ
uu	ऊ
hru	ऋ
ae	ए
aee	ऐ
o	ओ
ou	औ
da	द
dha	ध
pa	प
pha	फ
ba	ब
bha	भ
ma	म
ya	य
ra	र
la	ल
va	व
sha	श
Sha	ष
sa	स
ha	ह
Ta	ट
Tha	ठ
Da	ड
Dha	ढ
Na	ण
ta	त
tha	थ
da	द
dha	ध
na	न
ka	क
kha	ख
ga	ग
gha	घ
cha	च
Cha	छ
ja	ज
jha	झ
U	ु
U.	ू
A	ा
E	ि
E.	ी
E,	े
E/	ै
O	ो
O.	ौ
